11111011111
10000010111
10111110011
10100001011
10101100001
10101111101
10001e00101
11101110101
11000110001
11111111111